11111111111111111111
10000000000000000001
10030000000000003001
10000000000000000001
10111000000000111001
10000000000000000001
10000000000000000001
10000000000000000001
10001111000011110001
10040001020010040001
10000001000010000001
11111111111111111111