11111111111111111111
10000000000000000001
10030000000000003001
10000000000000000001
10110000000000110001
10000000000000000001
10000000000000000001
10000000000000000001
10001111000011110001
10040000020000040001
10000000000000000001
11111111111111111111