11111111111111111111
11111111111111111111
10000000004000100001
10400300000000100301
11115001111000110001
10005000006600000001
10005006006600000401
10005000000000000001
10001111555511110001
10601111060011110001
10000000020000000601
11111111111111111111