11111111111111111111
11111111111111111111
10000000004000100001
10000300000000100301
11110001111000110001
10000000000000000001
10000000000000000401
10000000000000000001
10001111000011110001
10001111000011110001
10200000000000000001
11111111111111111111