11111111111111111111
11111111111111111111
10000000000000100001
10000000000000100001
11110001111000110001
10000000000000000001
10000000000000000001
10000000000000000001
10001111000011110001
10001111000011110001
10000000000000000001
11111111111111111111