11111111111111111111
10000000000000000001
10300000000000003001
10000000000000000001
10111100066000111001
10000500066000500001
10600500000000500401
10000500000000500001
10001111000011110001
10060001020010060001
10000001000010000001
11111111111111111111