11111111111111111111
10000000000000000001
10006000000000000001
10011000000000110001
10011000000000110001
10000000000600000001
10000000000000000001
10011000000000110001
10011000000060110001
10000000000000000001
10060000000000000001
11111111111111111111